#########
#S     $#
# ##### #
#     # #
##### # #
#     #E#
#########