#########
#S      #
# ##### #
#     # #
##### # #
#     # #
#########