#########
#       #
# ##### #
#     # #
##### # #
#     #E#
#########