#####
#S  ###
#  #  #
#    E#
#####